%%%%%%%%%%
%        %
% b.bb.b %
%  .B .  %
% P. B.  %
% b.bb.b %
%        %
%%%%%%%%%%