%%%%%%%%%%%%%%%
%%%% %   % %%%%
%%%  %b%.b  %%%
%% b % %.%   %%
%% b % %.%   %%
%  b % %.%%   %
%  b % %.%    %
%% b % %.%%% %%
%% b   %.%   %%
%%   % %.%   %%
%%%b%   P   %%%
%%%   %%.%  %%%
%%%%    %  %%%%
%%%%%%%%%%%%%%%